...##...#..........
..#...#.#.##.##....
.##..###...#.......
##.................
#.....#.............
###..###...........
..#..#..............
.##.##.#...........
...................
##......##.........
.###..####........
.@..####...........