##........#....
.#..#...#.###..
.##...##..#..#.
......#........
#..###..##.##..
.#.#...#....##.
.#...#.........
...#.#.#.##.##.
..##...##.#...#
.....#.#....#..
.##..#..#..#...
#......#.....#@