#.....#....
...#..##.#.
.##....#@..
....#.###..
..#.#.#....
...#.....#.
.#...#.#.#.
##..#..##..
.#.###..#.#
......#....
..##....##.