.....#.#..#..#######...
##..#..#..#.#..#...#.#.
...##.....#.#..#.....#.
##......#.....#..###.#.
.#....###..........#...
....##......##.#....##.
.##..#...#..#..##......
..#..#.#.##.##.#.#.#..#
.@#..#.#.#..#....#.#..#
###......#.##.##...#..#
##########.....########