...#......
.#...#.##.
.###.#....
.....##.##
.##..#...#
...#...###
##.#.#..#.
...#.##...
.#.#.##.#.
..@#......